20 20
# # # # # # # # # # # # # # # # # # # #
# * * * * * * * * * * # # @ @ # # * * #
# * * * * * * * * * * * * * * * * * * #
# * * * * * * * * * * * * * * * * * * #
# * * * * * @ @ @ @ @ * * * * * @ * * #
# * * * @ * * * * * * * * * * * * * * #
# * * @ @ @ @ * * * @ @ @ @ @ * @ @ @ #
# * * @ * * * * * * @ * * * @ * * * * #
# * * @ * * * * * * @ * * * @ * * * @ #
# * * * * * * * * * * * * * * * * * * # 
# * * * * * * * * * * * * * * * * * * #
# @ * # * * * * * @ * * * * * @ * * * #
# * * * * * * * * @ * @ * * * * * * * #
# * * * * * * * * @ * @ * * * * * * * #
# * * * * * * * * * * * * * * * * * * #
# * * * * * * * * * * * * * * * * * * #
# * * * * * * * * * * * * * * * * * * #
# * * * * * @ @ @ # * # @ @ @ * * * * #
# * * * * * * * * * * * * * * * * * * #
# # # # # # # # # # # # # # # # # # # #
1 1
